50 80
0 0 1 0 0 0 0 0 0 / 0 0 0 0 0 0 0 0 0 / 0 0 0 0 0 0 0 0 0 / 0 0 0 0 0 0 0 0 0 / 0 0 0 0 0 0 0 0 0 / 0 0 0 0 0 0 0 0 0 / 0 0 0 0 0 0 0 0 0 / 0 0 0 0 2 0 0 0 0 / 
0 0 0 0 0 0 0 0 0 / 0 0 0 0 0 0 0 0 0 / 0 0 0 0 0 0 0 0 0 / 0 0 0 0 0 0 0 0 0 / 0 0 0 0 0 0 0 0 0 / 0 0 0 0 0 0 0 0 0 / 0 0 0 0 0 0 0 0 0 / 0 0 0 0 0 0 0 0 0 / 
0 0 0 0 0 0 0 0 0 / 0 0 0 0 0 0 0 0 0 / 0 0 0 0 0 0 0 0 0 / 0 0 0 0 0 0 0 0 0 / 0 0 0 0 0 0 0 0 0 / 0 0 0 0 0 0 0 0 0 / 0 0 0 0 0 0 0 0 0 / 0 0 0 0 0 0 0 0 0 / 
0 0 0 0 0 0 0 0 0 / 0 0 0 0 0 0 0 0 0 / 0 0 0 0 0 0 0 0 0 / 0 0 0 0 0 0 0 P P P P P P 0 0 0 0 0 0 / 0 0 0 0 0 0 0 0 0 / 0 0 0 0 0 0 0 0 0 / 0 0 0 0 0 0 0 0 0 / 
0 0 0 0 0 0 0 0 0 / 0 0 0 0 0 0 0 0 0 / 0 0 0 0 0 0 0 0 0 / 0 0 0 0 0 0 0 0 0 / 0 0 0 0 0 0 0 0 0 / 0 0 0 0 0 0 0 0 0 / 0 0 0 0 0 0 0 0 0 / 0 0 0 0 0 0 0 0 0 / 
0 0 0 0 0 0 0 0 0 / 0 0 0 0 0 0 0 0 0 / 0 0 0 0 0 0 0 0 P P P P P 0 0 0 0 0 0 / 0 0 0 0 0 0 0 P P P P P 0 0 0 0 0 0 0 / 0 0 0 0 0 0 0 0 0 / 0 0 0 0 0 0 0 0 0 / 
0 0 0 0 0 0 0 0 0 / 0 0 0 0 0 0 0 0 0 / 0 P P P 0 0 0 0 0 / 0 0 0 0 0 0 0 0 0 / 0 0 0 0 0 0 0 0 0 / 0 0 0 0 0 0 P P P / 0 0 0 0 0 0 0 0 0 / 0 0 0 0 0 0 0 0 0 / 
0 0 0 0 0 0 0 0 0 / 0 0 0 0 0 P P P 0 / 0 0 0 0 0 0 0 0 0 / 0 0 0 0 0 0 0 0 0 / 0 0 0 0 0 0 0 0 0 / 0 0 0 0 0 0 0 0 0 / 0 0 P P P P P 0 0 / 0 0 0 0 0 0 0 0 0 /
0 0 0 0 0 0 0 0 0 / 0 0 0 0 0 0 0 0 0 / 0 0 0 0 0 0 0 0 0 / 0 0 0 0 0 0 0 0 0 / 0 0 0 0 0 0 0 0 0 / 0 0 0 0 0 0 0 0 0 / 0 0 0 0 0 0 0 0 0 / 0 0 0 0 0 0 0 0 0 /  
0 0 0 0 0 0 0 0 0 / 0 0 0 0 0 0 0 0 0 / 0 0 0 0 0 0 0 0 0 / 0 0 0 0 0 0 0 0 0 / 0 0 0 0 0 0 0 0 0 / 0 0 0 0 0 0 0 0 0 / 0 0 0 0 0 0 0 0 0 / 0 0 0 0 0 0 0 0 0 / 

0 0 0 0 0 0 0 0 0 / 0 0 0 0 0 0 0 0 0 / 0 0 0 0 0 0 0 0 0 / 0 0 0 0 0 0 0 0 0 / 0 0 0 0 0 0 0 0 0 / 0 0 0 0 0 0 0 0 0 / 0 0 0 0 0 0 0 0 0 / 0 0 0 0 0 0 0 0 0 / 
0 0 0 0 0 0 0 0 0 P P 0 0 0 0 0 0 0 0 / 0 0 0 0 0 0 0 0 0 / 0 0 0 0 0 0 0 0 0 / 0 0 0 0 0 0 0 0 0 / 0 0 0 0 0 0 0 0 0 / 0 0 0 0 0 0 0 0 0 P P 0 0 0 0 0 0 0 0 / 
0 0 0 0 0 0 0 0 0 / 0 0 0 0 P P 0 0 0 / 0 0 0 0 0 0 0 0 0 / 0 0 0 0 0 0 0 0 0 / 0 0 0 0 0 0 0 0 0 / 0 0 0 0 0 0 0 0 0 / 0 0 0 0 P P 0 0 0 / 0 0 0 0 0 0 0 0 0 / 
0 0 0 P P P 0 0 0 / 0 0 0 0 0 0 0 0 0 / 0 0 0 0 0 0 0 0 0 / 0 0 0 0 0 0 0 0 0 / 0 0 0 0 0 0 0 0 0 / 0 0 0 0 0 0 0 0 0 / 0 0 0 0 0 0 0 0 0 / 0 0 0 0 0 0 0 0 0 / 
0 0 0 0 0 0 0 0 0 / 0 0 0 0 0 0 0 0 P P 0 0 0 0 0 0 0 0 0 / 0 0 0 0 0 0 0 0 0 / 0 0 0 0 0 0 0 0 0 / 0 0 0 0 0 0 0 0 0 / P P 0 0 0 0 0 0 0 / 0 0 0 0 P P P 0 0 / 
0 0 0 0 0 0 0 0 0 / 0 0 0 0 0 0 0 0 0 / 0 0 0 0 0 0 0 0 0 / 0 0 0 0 0 0 0 0 0 / 0 0 0 0 0 0 0 0 0 / 0 0 0 0 0 0 0 0 0 / 0 0 0 0 0 0 0 0 0 / 0 0 0 0 0 0 0 0 0 / 
0 0 0 0 0 0 0 0 0 / 0 0 0 0 0 0 0 0 0 / 0 0 P P 0 0 0 0 0 / 0 0 0 0 0 0 0 0 0 / 0 0 0 0 0 0 0 0 0 / 0 0 0 0 0 0 P P 0 / 0 0 0 0 0 0 0 0 0 / 0 0 0 0 0 0 0 0 0 / 
0 0 0 0 0 0 0 0 0 / 0 0 0 0 0 0 0 0 0 / 0 0 0 0 0 0 0 0 0 / 0 0 0 0 0 0 0 0 0 / 0 0 0 0 0 0 0 0 0 / 0 0 0 0 0 0 0 0 0 / 0 0 0 0 0 0 0 0 0 / 0 0 0 0 0 0 0 0 0 /
0 0 P P P P 0 0 0 / 0 0 0 0 0 0 0 0 0 / 0 0 0 0 0 0 P P 0 / 0 0 0 0 0 0 0 0 0 / 0 0 0 0 0 0 0 0 0 / 0 0 P P 0 0 0 0 0 / 0 0 0 0 0 0 0 0 0 / 0 0 0 0 P P P P 0 / 
0 0 0 0 0 0 0 0 0 / 0 0 0 0 0 0 0 0 0 / 0 0 0 0 0 0 0 0 0 / 0 0 0 0 0 0 0 0 0 / 0 0 0 0 0 0 0 0 0 / 0 0 0 0 0 0 0 0 0 / 0 0 0 0 0 0 0 0 0 / 0 0 0 0 0 0 0 0 0 / 

0 0 0 0 0 0 0 0 0 / 0 0 0 0 0 0 0 0 0 / 0 0 0 0 0 0 0 0 0 / P P 0 0 0 0 0 0 0 / 0 0 0 0 0 0 0 0 P P 0 0 0 0 0 0 0 0 0 / 0 0 0 0 0 0 0 0 0 / 0 0 0 0 0 0 0 0 0 / 
0 0 0 0 0 0 0 0 0 / 0 0 0 0 0 0 0 0 0 / 0 0 0 0 0 0 0 0 0 / 0 0 0 0 0 0 0 0 0 / 0 0 0 0 0 0 0 0 0 / 0 0 0 0 0 0 0 0 0 / 0 0 0 0 0 0 0 0 0 / 0 0 0 0 0 0 0 0 0 / 
0 0 0 0 0 0 0 0 0 / 0 0 0 0 0 0 0 0 0 / 0 0 0 0 0 0 0 0 0 / 0 0 0 0 P 0 0 0 0 / 0 0 0 0 0 P 0 0 0 / 0 0 0 0 0 0 0 0 0 / 0 0 0 0 0 0 0 0 0 / 0 0 0 0 0 0 0 0 0 / 
0 0 0 0 0 0 0 0 0 / 0 0 0 0 0 0 0 0 0 / 0 0 0 0 0 0 0 0 0 / 0 0 0 0 0 0 0 0 0 / 0 0 0 0 0 0 0 0 0 / 0 0 0 0 0 0 0 0 0 / 0 0 0 0 0 0 0 0 0 / 0 0 0 0 0 0 0 0 0 / 
0 P P P P P 0 0 0 / 0 0 0 0 0 0 0 0 0 / 0 0 0 0 0 0 0 0 0 / 0 0 0 0 0 0 0 0 P P P P 0 0 0 0 0 0 0 / 0 0 0 0 0 0 0 0 0 / 0 0 0 0 0 0 0 0 0 / 0 0 0 0 P P P P P / 
0 0 0 0 0 0 0 0 0 / 0 0 0 0 0 0 0 0 0 / 0 0 0 0 0 0 0 0 0 / 0 0 0 0 0 0 0 0 0 / 0 0 0 0 0 0 0 0 0 / 0 0 0 0 0 0 0 0 0 / 0 0 0 0 0 0 0 0 0 / 0 0 0 0 0 0 0 0 0 / 
0 0 0 0 0 0 0 0 0 / 0 0 0 0 0 0 0 0 0 / 0 0 0 0 0 0 0 0 0 / 0 0 0 0 0 0 0 0 0 / 0 0 0 0 0 0 0 0 0 / 0 0 0 0 0 0 0 0 0 / 0 0 0 0 0 0 0 0 0 / 0 0 0 0 0 0 0 0 0 / 
0 0 0 0 0 0 0 0 0 / 0 0 0 0 0 0 0 0 0 / 0 0 0 0 0 0 0 0 0 / 0 0 0 0 P 0 0 0 0 / 0 0 0 0 0 P 0 0 0 / 0 0 0 0 0 0 0 0 0 / 0 0 0 0 0 0 0 0 0 / 0 0 0 0 0 0 0 0 0 /
0 0 0 0 0 0 0 0 0 / 0 0 0 0 0 0 0 0 0 / 0 0 0 0 0 0 0 0 0 / 0 0 0 0 0 0 0 0 0 / 0 0 0 0 0 0 0 0 0 / 0 0 0 0 0 0 0 0 0 / 0 0 0 0 0 0 0 0 0 / 0 0 0 0 0 0 0 0 0 / 
0 0 0 0 0 0 0 0 0 / 0 0 0 0 0 0 0 0 0 / 0 0 0 0 0 0 0 0 0 / P P 0 0 0 0 0 0 0 / 0 0 0 0 0 0 0 0 P P 0 0 0 0 0 0 0 0 0 / 0 0 0 0 0 0 0 0 0 / 0 0 0 0 0 0 0 0 0 / 

0 0 P P P P 0 0 0 / 0 0 0 0 0 0 0 0 0 / 0 0 0 0 0 0 0 0 0 / 0 0 0 0 0 0 0 0 0 / 0 0 0 0 0 0 0 0 0 / 0 0 0 0 0 0 0 0 0 / 0 0 0 0 0 0 0 0 0 / 0 0 0 0 P P P P 0 / 
0 0 0 0 0 0 0 0 0 / 0 0 0 0 0 0 0 0 0 / 0 0 0 0 0 0 P P 0 / 0 0 0 0 0 0 0 0 0 / 0 0 0 0 0 0 0 0 0 / 0 0 P P 0 0 0 0 0 / 0 0 0 0 0 0 0 0 0 / 0 0 0 0 0 0 0 0 0 / 
0 0 0 0 0 0 0 0 0 / 0 0 0 0 0 0 0 0 0 / 0 0 0 0 0 0 0 0 0 / 0 0 0 0 0 0 0 0 0 / 0 0 0 0 0 0 0 0 0 / 0 0 0 0 0 0 0 0 0 / 0 0 0 0 0 0 0 0 0 / 0 0 0 0 0 0 0 0 0 / 
0 0 0 0 0 0 0 0 0 / 0 0 0 0 0 0 0 0 0 / 0 0 P P 0 0 0 0 0 / 0 0 0 0 0 0 0 0 0 / 0 0 0 0 0 0 0 0 0 / 0 0 0 0 0 0 P P 0 / 0 0 0 0 0 0 0 0 0 / 0 0 0 0 0 0 0 0 0 / 
0 0 0 0 0 0 0 0 0 / 0 0 0 0 0 0 0 0 0 / 0 0 0 0 0 0 0 0 0 / 0 0 0 0 0 0 0 0 0 / 0 0 0 0 0 0 0 0 0 / 0 0 0 0 0 0 0 0 0 / 0 0 0 0 0 0 0 0 0 / 0 0 0 0 0 0 0 0 0 / 
0 0 0 P P P 0 0 0 / 0 0 0 0 0 0 0 0 P P 0 0 0 0 0 0 0 0 0 / 0 0 0 0 0 0 0 0 0 / 0 0 0 0 0 0 0 0 0 / 0 0 0 0 0 0 0 0 0 / P P 0 0 0 0 0 0 0 / 0 0 0 0 P P P 0 0 / 
0 0 0 0 0 0 0 0 0 / 0 0 0 0 0 0 0 0 0 / 0 0 0 0 0 0 0 0 0 / 0 0 0 0 0 0 0 0 0 / 0 0 0 0 0 0 0 0 0 / 0 0 0 0 0 0 0 0 0 / 0 0 0 0 0 0 0 0 0 / 0 0 0 0 0 0 0 0 0 / 
0 0 0 0 0 0 0 0 0 / 0 0 0 0 P P 0 0 0 / 0 0 0 0 0 0 0 0 0 / 0 0 0 0 0 0 0 0 0 / 0 0 0 0 0 0 0 0 0 / 0 0 0 0 0 0 0 0 0 / 0 0 0 0 P P 0 0 0 / 0 0 0 0 0 0 0 0 0 /
0 0 0 0 0 0 0 0 0 / 0 0 0 0 0 0 0 0 0 / 0 0 0 0 0 0 0 0 0 / 0 0 0 0 0 0 0 0 0 / 0 0 0 0 0 0 0 0 0 / 0 0 0 0 0 0 0 0 0 / 0 0 0 0 0 0 0 0 0 / 0 0 0 0 0 0 0 0 0 / 
0 0 0 0 0 0 0 0 0 / 0 0 0 0 0 0 0 0 0 / 0 0 0 0 0 0 0 0 0 / 0 0 0 0 0 0 0 0 0 / 0 0 0 0 0 0 0 0 0 / 0 0 0 0 0 0 0 0 0 / 0 0 0 0 0 0 0 0 0 / 0 0 0 0 0 0 0 0 0 / 

0 0 0 0 0 0 0 0 P P P 0 0 0 0 0 0 0 0 / 0 0 0 0 0 0 0 0 0 / 0 0 0 0 0 0 0 0 0 / 0 0 0 0 0 0 0 0 0 / 0 0 0 0 0 0 0 0 0 / 0 0 0 0 0 0 0 0 0 P P P 0 0 0 0 0 0 0 / 
0 0 0 0 0 0 0 0 0 / 0 0 0 0 0 0 0 0 0 / 0 0 0 0 0 0 0 0 0 / 0 0 0 0 0 0 0 0 0 / 0 0 0 0 0 0 0 0 0 / 0 0 0 0 0 0 0 0 0 / 0 0 0 0 0 0 0 0 0 / 0 0 0 0 0 0 0 0 0 / 
0 0 0 0 0 0 0 0 0 / 0 0 0 P P P P P 0 / 0 0 0 0 0 0 0 0 0 / 0 0 0 0 0 0 0 0 0 / 0 0 0 0 0 0 0 0 0 / 0 0 0 0 0 0 0 0 0 / 0 0 P P P P P 0 0 / 0 0 0 0 0 0 0 0 0 / 
0 0 0 0 0 0 0 0 0 / 0 0 0 0 0 0 0 0 0 / 0 P P P P 0 0 0 0 / 0 0 0 0 0 0 0 0 0 / 0 0 0 0 0 0 0 0 0 / 0 0 0 0 0 P P P P / 0 0 0 0 0 0 0 0 0 / 0 0 0 0 0 0 0 0 0 / 
0 0 0 0 0 0 0 0 0 / 0 0 0 0 0 0 0 0 0 / 0 0 0 0 0 0 0 0 P P P P P 0 0 0 0 0 0 / 0 0 0 0 0 0 0 P P P P P 0 0 0 0 0 0 0 / 0 0 0 0 0 0 0 0 0 / 0 0 0 0 0 0 0 0 0 / 
0 0 0 0 0 0 0 0 0 / 0 0 0 0 0 0 0 0 0 / 0 0 0 0 0 0 0 0 0 / 0 0 0 0 0 0 0 0 0 / 0 0 0 0 0 0 0 0 0 / 0 0 0 0 0 0 0 0 0 / 0 0 0 0 0 0 0 0 0 / 0 0 0 0 0 0 0 0 0 / 
0 0 0 0 0 0 0 0 0 / 0 0 0 0 0 0 0 0 0 / 0 0 0 0 0 0 0 0 0 / 0 0 0 0 0 0 P P P P P P P P 0 0 0 0 0 / 0 0 0 0 0 0 0 0 0 / 0 0 0 0 0 0 0 0 0 / 0 0 0 0 0 0 0 0 0 / 
0 0 0 0 0 0 0 0 0 / 0 0 0 0 0 0 0 0 0 / 0 0 0 0 0 0 0 0 0 / 0 0 0 0 0 0 0 0 0 / 0 0 0 0 0 0 0 0 0 / 0 0 0 0 0 0 0 0 0 / 0 0 0 0 0 0 0 0 0 / 0 0 0 0 0 0 0 0 0 /
0 0 0 0 0 0 0 0 0 / 0 0 0 0 0 0 0 0 0 / 0 0 0 0 0 0 0 0 0 / 0 0 0 0 0 0 0 0 0 / 0 0 0 0 0 0 0 0 0 / 0 0 0 0 0 0 0 0 0 / 0 0 0 0 0 0 0 0 0 / 0 0 0 0 0 0 0 0 0 / 
0 0 0 0 0 0 0 0 0 / 0 0 0 0 0 0 0 0 0 / 0 0 0 0 0 0 0 0 0 / 0 0 0 0 0 0 0 0 0 / 0 0 0 0 0 0 0 0 0 / 0 0 0 0 0 0 0 0 0 / 0 0 0 0 0 0 0 0 0 / 0 0 0 0 0 0 0 0 0 / 